0 0 0 0 0 0 0 0 0 0 0
0 0 0 0 0 0 0 0 0 0 0
0 1 1 1 1 0 1 1 1 1 0
0 1 2 2 1 0 1 3 3 1 0
0 1 2 2 1 0 1 3 3 1 0
0 1 1 1 1 0 1 1 1 1 0
0 0 0 0 0 0 0 0 0 0 0
0 0 0 0 0 0 0 0 0 0 0
0 0 5 5 5 5 5 5 5 0 0
0 0 5 6 8 6 8 6 5 0 0
0 0 5 6 6 6 6 6 5 0 0
0 0 5 5 5 5 5 5 5 0 0
0 0 0 0 0 0 0 0 0 0 0
