9 0 0 0 8 1 8 0 0 0 9
0 0 0 0 0 8 0 0 0 0 0
0 0 0 0 0 0 0 0 0 0 0
0 0 0 0 0 0 0 0 0 0 0
8 2 3 4 5 9 5 4 3 2 8
2 3 4 3 4 5 4 3 4 3 2
3 4 5 4 3 4 3 4 5 4 3
4 5 6 5 4 3 4 5 6 5 4
5 6 8 6 5 4 5 6 8 6 5
6 8 1 8 6 5 6 8 1 8 6
8 9 8 9 8 9 8 9 8 9 8
0 0 0 0 0 0 0 0 0 0 0
0 0 0 0 0 0 0 0 0 0 0
